WWWWWWWWWWWWWWWWWWWWWWWWWWWWWWWWWWWWWWWW
WSSSSSSSSSSSSSWSSSSSSSSSSSWSSSSSSSSSSSSW
WSSSSSSSSSSSSSWSSSSSSSSSSSWSSSSSSSSSSSSW
WSSSSSSSSSSSSSWSSSSSSSSSSSWSSSSSSRSSSSSW
WSSSSSSSSSSSSSWSSSSSSSSSSSWSSSSSSSSSSSSW
WSSSSSSSSSSSSSWSSSSSSSSSSSWSSSSSSSSSSSSW
WSSSSSSSSSSSSSWSSSSSSSSSSSWSSSSSSSSSSSSW
WSSSSSSSSSSSSSWSSSSpiySSSSWSSSSSSSSSSSSW
WSSSSSSSSSSSSSWSSSSSSSSSSSWSSSSSSSSSSSSW
WSSSSSSSSSSSSSWSSSSSSSSSSSWSSSSSSSSSSSSW
WSSSSSPSSSSSSSRSSSSSSSSSSSWSSSSSSSSSSSSW
WSSSSSSSSSSSSSRSSSSSSSSSSSWSSSSSSSSSSSSW
WSSSSSSSSSSSSSWSSSSSSSSSSSWSSSSSSSSSSSSW
WSSSSSrSSSSSSSWSSSSSSSSSSSWSSSSSSSSSSSSW
WSSSSSSiSSSSSSWSSSSSSSSSSSWSSSSSSSSSSSSW
WSSSSSSmSSSSSSWSSSSSSSSSSSWSSSSSSSSSSSSW
WSSSSSSSSSSSSSWSSSSSSSSSSSWSSSSSSSSSSSSW
WSSSSSSSSSSSSSWSSSSSSSSSSSWSSSSSSSSSSSSW
WSSSSSSSSSSSSSWSSSSSSSSSSSWSSSSSSSSSSSSW
WSSSSSSSSSSSSSWSSSSSSSSSSSWSSSSSSSSSSSSW
WSSSSSSSSSSSSSWSSSSSSSSSSSWSSSSSSSSSSSSW
WSSSSSSSSSSSSSWSSSSSSSSSSSWSSSSSFSSSSSSW
WWWWWSSSSSSSSSWSSSSSSSSSSSWSSSSSSSSSSSSW
WfivWSSSSSSSSSWSSSSSSSSSSSWSSSSSSSSSSSSW
WWWWWWWWWWWWWWWWWWWWWWWWWWWWWWWWWWWWWWWW