WWWWWWWWWWWWWWWWWWWWWWWWWWWWWWWWWWWWWWWW
WBBBBBBBBBBBBBBBBBBBBBBBBBBBBBBBBBBBBBBW
WBfivRSSSSSSSSSSSSSSSSSSSSSSSSSSSSSSRFBW
WBRRRRSSSSSSSSSSSSSSSSSSSSSSSSSSSSSSRRBW
WBSSSSSSSSPSSSSSSSSSSSSSSSSSSSSSSSSSSSBW
WBSSSSSSSSSSSSSSSSSSSSSSSSSSSSSSSSSSSSBW
WBSSSSSSSSSSSSSSSSSSSSSSSSSSSSSSSSSSSSBW
WBSSSSSSSSSSSSSSSSSSSSSSSSSSSSSSSSSSSSBW
WBSSSSSSSSSSSSSSSSSSSSSSSSSSSSSSSSSSSSBW
WBSSSSSSSSbSSSSSSSSSSSSSSSSSSSSSSSSSSSBW
WBSSSSSSSSSSSSSSSSSSSSSSSSSSSSSSSSSSSSBW
WBSSSSSSSSSSSSSSSSSSSSSSSSSSSSSSSSSSSSBW
WBSSSSSSSSSSSSSSSSSSSSSSSSSSSSSSSSSSSSBW
WBSSSSSSSSSSSSSSSSSSSSSSSSSSSSSSSSSSSSBW
WBSSSSSSSSSSSSSSSSSSSSSSSSSSSSSSSSSSSSBW
WBSSSSSSSSSSSSSSSSSSSSSSSSSSSSSSSSSSSSBW
WBBBBBBBBBBBBBBBBBBBSSSSSSSSSSrimSSSSSBW
WBSSSSSSSSSSSSSSSSSBSSSSSSSSSSSSSSSSSSBW
WBSSSSSSSSSSSSSSSSSBSSSSSSSSSSSSSSSSSSBW
WBSSSSSSSSpiySSSSSSBSSSSSSSSSSSSSSSSSSBW
WBSSSSSSSSSSSSSSSSSBSSSSSSSSSSSSSSSSSSBW
WBSSSSSSSSSSSSSSSSSBSSSSSSSSSSSSSSSSSSBW
WBSSSSSSSSSSSSSSSSSBSSSSSSSSSSSSSSSSSSBW
WBBBBBBBBBBBBBBBBBBBBBBBBBBBBBBBBBBBBBBW
WWWWWWWWWWWWWWWWWWWWWWWWWWWWWWWWWWWWWWWW