WWWWWWWWWWWWWWWWWWWWWWWWWWWWWWWWWWWWWWWW
WSSSSSSSSWFdSSSSSSSWSSSSSSSSSWSSSSSSSSSW
WSSSSSSSSWfivSSSSSSWSSSSSSSSSWSSSSSSSSSW
WSSkioSSSWSsSSSSSSSWSSSSSSSSSWSSSSSSSSSW
WSSSSSSSSWSSSSSSSSSWSSSSSSSSSWSSSSSSSSSW
WSSSSSSSSWSSSSSSSSSWSSSSSSSSSWSSSSSSSSSW
WSSrimSSSWSSSSSSSSSWSSSSSSSSSDSSSSSSSSSW
WSSSSSSSSWSSSSSSSSSWSSSSSSSSSWSSSSSSSSSW
WSSSSSSSSWSSSSSSSSSWSSSSSSSSSWSSSSSSSSSW
WSSSSSSSSWSSSSSSSSSWSSSSSSSSSWSSSSSSSSSW
WSSSSSSSSWSSSSSSSSSWSSSSSSSSSWSSSSSSSSSW
WSSSSSSSSWSSSSSSSSSWSSSSSSSSSWSSSSSSSSSW
WSSSSSSSSDSSSSSSSSSWRRRRRRRRRWKKKKKKKKKW
WSSSSSSSSWSSSSSSSSSWSSSSSSSSSWSSSSSSSSSW
WSSSSSSSSWSSSSSSSSSWSSSSSSSSSWSSSSSSSSSW
WSSSSSSSSWSSSSSSSSSWSSSSSSSSSWSSSSSSSSSW
WSSSSSSSSWSSSSSSSSSWSSSSSSSSSWSSSSSSSSSW
WSSSSSSSSWSSSSSSSSSWSSSSSSSSSWSSSSSSSSSW
WSSSSPSSSWSSSSSSSSSDSSSSSSSSSWSSSSPSSSSW
WSSSSSSSSWSSSSSSSSSWSSSSSSSSSWSSSSSSSSSW
WSSSSSSSSWSSSSSSSSSWSSSSSSSSSWSSSSSSSSSW
WSSSSSSSSWSSSSSSSSSWSSSSSSSSSWSSSSSSSSSW
WWWWWSSSSWSSSSSSSSSWSSSSSSSSSWSSSSSSSSSW
WpiyWSSSSWSSSSSSSSSWSSSSSSSSSWSSSSSSSSSW
WWWWWWWWWWWWWWWWWWWWWWWWWWWWWWWWWWWWWWWW