WWWWWWWWWWWWWWWWWWWWWWWWWWWWWWWWWWWWWWWW
WSSSWSSSSSSSWSSWWWSSWWWWWWSSSWSSSSSWpiyW
WSvSWSSSSSSSSSSSSSSSWSSSSSSiSWSSSSSWWWWW
WSSSWWWWWWSSSSSSSSSSWSSSSSSSSWSSSSSSSSSW
WSSSSSSSSSSSWSSWSSWWWSSWWWWWWWSSSSSSSSSW
WSSSSSSSSSSSWWWWSSWWWSSWSSSSSWSSSSSSSSSW
WWWWWWWWWWSSWWSSSSWWWSSWSSSSSWSSSSSSSSSW
WSSSSSWWWWSSWWSSSSWSSSSSWWWSSWSSSSSSSSSW
WSSSSSWWSSSSSWSSWWWSSSSSWWWSSWSSSSSSSSSW
WWWWSSWWSSSSSWSSWSSSSWSSSSWSSWSSSSSSSSSW
WSSSSSSSWWSSWWSSWSSSSWSSSSSSSWSSSSSSSSSW
WSSSSSSSWWSSWWSSWWWSSWWWSSSSSWSSSSSSSSSW
WSSWWWSSSSSSSSPSSSSSSWSSSSWSSWSSSSSSSSSW
WSSWWWSSSSSSSSSSSSSSSWSSSSWSSWSSSSSSSSSW
WSSWWWWWWWWWWWSSWWWWWWSSWWSSSWSSSSSFSSSW
WSSSSSSSSSSSSWSSWWWWWWSSWSSSSWSSSSSSSSSW
WSSSSSSSSSSSSWSSWSSSSSSSWSSSSWSSSSSSSSSW
WSSWSSWSSWWSSWSSWSSSSSSSWWWWWWSSSSSSSSSW
WSSWSSWSSSWSSWSSWWWWSSWWWWWWWWSSSSSSSSSW
WSSWSSWSSSWSSWSSSWSSSSSSSSSSSSSSSSSSSSSW
WWWWWWWWSSWSSWSSSWSSSSSSSSSSSSSSSSSSSSSW
WSSSSSSSSSWWWWSSWWWWWWSSWSSWWWSSSSSSSSSW
WSfSSSSSSSWSSSSSWSSSSSSSWSSSWWSSSSSSSSSW
WSSSWWWWSSWSSSSSWSSSSSSSWSSSWWSSSSSSSSSW
WWWWWWWWWWWWWWWWWWWWWWWWWWWWWWWWWWWWWWWW